type octile
height 10
width 10
map
TTTTTTTTTT
Ts...T..TT
T..T.....T
T...T....T
T..TTT..TT
TT.......T
TTTTTT.TTT
T.......TT
TTT.T.TTTT
TTTTTeTTTT